111111111111
10C0011C00C1
1110C1C00001
1C000001C001
1P00001100E1
111111111111
