1111111111
100C1C0001
1P1000C1E1
1111111111
